NO textures/checker_north.xpm
SO textures/checker_south.xpm
WE textures/checker_west.xpm
EA textures/checker_east.xpm

F 34,139,34
C 135,206,235

1111111111111
1000000000001
1000000000001
1000000011111
1000N00011011
1000000011011
1000000011011
1000000000001
1111111111111