WE                     textures/checker_west.xpm
NO textures/checker_north.xpm
SO    textures/checker_south.xpm


     C 135,206,235
EA textures/checker_east.xpm

F     34,139,34









   111111111         
   1000000011111       
1111000000011111         
100000000001            1111
1000N000111           1111111
100000001                1111
1000000011111        
100000001            
111111111111111111  
                              

1
